111111111111111
100022002200221
101210101212101
100020220020021
121212101212121
100020000022021
101210121010101
102200220020001
121012121210101
120220002200221
121010101010101
100000202220201
101212101010121
100202202022001
111111111111111