111111111111111
100000220002001
101210101212101
102202220220001
121010101012121
100020000000221
101212121010121
122200220000001
101010121010101
100020202200221
121212121012121
122200200020001
101012101212101
100222002202201
111111111111111