111111111111111
100000000220001
101212101010101
122002022000001
101012121212121
100202022200201
121012121012101
120222020000221
101212121010101
100220002220021
121010101012101
120220000000221
101010121210101
100020000220001
111111111111111